ID = (int)record["ID"];
OfferNumber = (record["OfferNumber"] ?? "").ToString();
Number = (record["Number"] ?? "").ToString();
StateID = (int)record["StateID"];
Name = (record["Name"] ?? "").ToString();
OfferName = (record["OfferName"] ?? "").ToString();
Description = (record["Description"] ?? "").ToString();
OfferDate = (DateTime)record["OfferDate"];
CommisionDate = (DateTime)record["CommisionDate"];
EstimatedStartDate = (DateTime)record["EstimatedStartDate"];
EstimatedEndDate = (DateTime)record["EstimatedEndDate"];
SupervisorID = (int)record["SupervisorID"];
ManagerID = (int)record["ManagerID"];
LeaderID = (int)record["LeaderID"];
TypeID = (int)record["TypeID"];
ConstructionSiteCountryID = (int)record["ConstructionSiteCountryID"];
ConstructionSiteProvinceID = (int)record["ConstructionSiteProvinceID"];
ConstructionSiteCity = (record["ConstructionSiteCity"] ?? "").ToString();
ConstructionSiteStreetAndNumber = (record["ConstructionSiteStreetAndNumber"] ?? "").ToString();
ConstructionSitePostCode = (record["ConstructionSitePostCode"] ?? "").ToString();
MarketSectionID = (int)record["MarketSectionID"];
MainContractID = (int)record["MainContractID"];
CompanyID = (int)record["CompanyID"];
ProjectNumberClient = (record["ProjectNumberClient"] ?? "").ToString();
ProjectNameClient = (record["ProjectNameClient"] ?? "").ToString();
ProjectNumberArchitect = (record["ProjectNumberArchitect"] ?? "").ToString();
ProjectNameArchitect = (record["ProjectNameArchitect"] ?? "").ToString();
Probability = (int)record["Probability"];
RootFolder = (record["RootFolder"] ?? "").ToString();
PhotoUrl = (record["PhotoUrl"] ?? "").ToString();
IsDeclarable = (bool)record["IsDeclarable"];
PerfectViewID = (record["PerfectViewID"] ?? "").ToString();